0000000000
0000000000
0000000000
0000000000
0001100000
0001100000
0000000000
0000000000
0000000000
0000000000
0000000000
0000000000
0000000000
0000000000
0011100000
0100010000
1000001000
1000001000
0001000000
0100010000
0011100000
0001000000
0000000000
0000000000
0000111000
0000111000
0001000100
0000000000
0011000110
0000000000
0000000000
0000000000
0000000000
0000000000
0000000000
0000000000
0000000000
0000000000
0000011000
0000011000
